...###.....................................
..##.#.####................................
.##..###..#................................
##........#................................
#......#..#................................
###..###..#.....................@..........
..#..#....#................................
.##.##.#.##................................
.#......##................................
.#.....##................................
.#######................................